
pathologists: a doctor who specializes in medical diagnosis

sweetbriar: Eurasian rose with prickly stems and fragrant leaves and bright pink flowers followed by scarlet hips

mosaic: art consisting of a design made of small pieces of colored stone or glass

theurgy: the effect of supernatural or divine intervention in human affairs

professor: someone who is a member of the faculty at a college or university

protectionist: an advocate of protectionism

tease: someone given to teasing (as by mocking or stirring curiosity)

prophetess: a woman prophet

carryall: a capacious bag or basket

coliphage: a bacteriophage that infects the bacterium Escherichia coli

disarmers: someone opposed to violence as a means of settling disputes

homeless: someone unfortunate without housing

flurries: a rapid active commotion

bergamots: small tree with pear-shaped fruit whose oil is used in perfumery; Italy

aesthetics: (art) the branch of philosophy dealing with beauty and taste (emphasizing the evaluative criteria that are applied to art)

microscopies: research with the use of microscopes

cantilevers: projecting horizontal beam fixed at one end only

adrenergic: drug that has the effects of epinephrine

hypozeugma: use of a series of subjects with a single predicate

arena: a particular environment or walk of life

induration: any pathological hardening or thickening of tissue

weightings: (statistics) a coefficient assigned to elements of a frequency distribution in order to represent their relative importance

motorbike: small motorcycle with a low frame and small wheels and elevated handlebars

lionfishes: brightly striped fish of the tropical Pacific having elongated spiny fins

tapioca: granular preparation of cassava starch used to thicken especially puddings

shuteye: informal term for sleep

gravimetry: the measurement of specific gravity

runner: someone who imports or exports without paying duties

steaminess: cloudiness resulting from haze or mist or vapor

phenylethylene: a colorless oily liquid; the monomer for polystyrene

enthalpy: (thermodynamics) a thermodynamic quantity equal to the internal energy of a system plus the product of its volume and pressure

concessionaires: someone who holds or operates a concession

bhutani: a native or inhabitant of Bhutan

unwellness: impairment of normal physiological function affecting part or all of an organism

pooler: someone who shares in and contributes to a general fund for use by all

blockage: the physical condition of blocking or filling a passage with an obstruction

sherbet: a frozen dessert made primarily of fruit juice and sugar, but also containing milk or egg-white or gelatin

paddock: pen where racehorses are saddled and paraded before a race

fenrir: (Norse mythology) an enormous wolf that was fathered by Loki and that killed Odin

concretion: the formation of stonelike objects within a body organ (e.g., the kidneys)

pacers: a horse used to set the pace in racing

scan: the act of scanning; systematic examination of a prescribed region

heredities: the biological process whereby genetic factors are transmitted from one generation to the next

swaps: an equal exchange

shipping: the commercial enterprise of moving goods and materials

superior: one of greater rank or station or quality

overestimation: an appraisal that is too high

millepede: any of numerous herbivorous nonpoisonous arthropods having a cylindrical body of 20 to 100 or more segments most with two pairs of legs

lewis: United States rock star singer and pianist (born in 1935)

falconries: the art of training falcons to hunt and return

barbiturates: organic compound having powerful soporific effect; overdose can be fatal

lignins: a complex polymer; the chief constituent of wood other than carbohydrates; binds to cellulose fibers to harden and strengthen cell walls of plants

consumptions: the process of taking food into the body through the mouth (as by eating)

mussitation: a low continuous indistinct sound; often accompanied by movement of the lips without the production of articulate speech

gopherwood: small handsome roundheaded deciduous tree having showy white flowers in terminal clusters and heavy hardwood yielding yellow dye

sceliphron: mud daubers

stringybark: any of several Australian eucalypts having fibrous inner bark

baster: a cook who bastes roasting meat with melted fat or gravy

carpers: someone who constantly criticizes in a petty way

stagers: someone who supervises the physical aspects in the production of a show and who is in charge of the stage when the show is being performed

yacks: noisy talk

tapas: the thin fibrous bark of the paper mulberry and Pipturus albidus

adamants: very hard native crystalline carbon valued as a gem

proaccelerin: a coagulation factor

alstonia: genus of evergreen trees or shrubs with white funnel-shaped flowers and milky sap; tropical Africa to southeastern Asia and Polynesia

raper: someone who forces another to have sexual intercourse

wolds: a tract of open rolling country (especially upland)

microbiology: the branch of biology that studies microorganisms and their effects on humans

buhls: an inlaid furniture decoration; tortoiseshell and yellow and white metal form scrolls in cabinetwork

settlings: sediment that has settled at the bottom of a liquid

landman: a person who lives and works on land

li: a soft silver-white univalent element of the alkali metal group; the lightest metal known; occurs in several minerals

louse: wingless usually flattened bloodsucking insect parasitic on warm-blooded animals

yogin: United States baseball player (born 1925)

coloratura: a lyric soprano who specializes in coloratura vocal music

satinpod: southeastern European plant cultivated for its fragrant purplish flowers and round flat papery silver-white seedpods that are used for indoor decoration

ephemeral: anything short-lived, as an insect that lives only for a day in its winged form

palpebra: either of two folds of skin that can be moved to cover or open the eye

antipyretics: any medicine that lowers body temperature to prevent or alleviate fever

jujube: spiny tree having dark red edible fruits

conversationalist: someone skilled at conversation

brahma: the Creator; one of the three major deities in the later Hindu pantheon

racetrack: a course over which races are run

dainties: something considered choice to eat

coiffeuses: a woman hairdresser

treehopper: small leaping insect that sucks juices of branches and twigs

triggers: lever that activates the firing mechanism of a gun

thrombolysis: the process of breaking up and dissolving blood clots

cedrus: true cedars

suitcase: a portable rectangular container for carrying clothes

probabilities: a measure of how likely it is that some event will occur; a number expressing the ratio of favorable cases to the whole number of cases possible

balibago: shrubby tree widely distributed along tropical shores; yields a light tough wood used for canoe outriggers and a fiber used for cordage and caulk; often cultivated for ornament

catcher: (baseball) the person who plays the position of catcher

emblem: special design or visual object representing a quality, type, group, etc.

devilry: wicked and cruel behavior

spider: predatory arachnid with eight legs, two poison fangs, two feelers, and usually two silk-spinning organs at the back end of the body; they spin silk to make cocoons for eggs or traps for prey

spreads: process or result of distributing or extending over a wide expanse of space

homestretches: the end of an enterprise

alumbloom: any of several herbs of the genus Heuchera

sacrifices: the act of losing or surrendering something as a penalty for a mistake or fault or failure to perform etc.
